_____________________________   
|                           |
|      @                    |
|                           |
|          @                |
|                           |
|---------------------------|
|                    @      |
|    @                      |
|        @                  |
|                           |
|---------------------------|
|                           |
|                           |
|                           |
|___________________________|
